***...........**
...**......***..
.....*....**....
......*..*......
........@...****
******..........
.....*.......*..
...........**...
*....*...*...***