...***..........
..**.*.***...*..
.**..***.....***
**..........*...
*..*.*.*..@.....
********.....***
..*..*......**..
.**.**.*.*.**...
.*......****....