@..*........*...
**...******.*.*.
.*.**.....*...*.
.*.*..***.*****.
.*.*.**.*...*...
.*....*.***...**
.****.*...**.**.
...*..**..**....
.*.........*****